1111111111111111111111111
1000000000000000000000001
1011111101111010000100001
1010000101000010000100001
1010000101000010000100001
1011111101111010000100001
1010000101000010000100001
1010000101000010000100001
1011111101111011110111101
1000000000000000000000001
100000000000000000c000001
1000000000000000000000001
1000000000000000000000001
1000000000000000000000001
100000000000p000000000001
1000000000000000000000001
1000000000000000000000001
1000000000000000000000001
1111111111111111111111111